%%%%
%% %
%P.%                          
%%%%
