%%%%%%%
%P  %%%
%%% %%%
%%%.%%%
%%%%%%%
%%%%%%%
