%%%%%%%%%
%%%%%%%%%
%P%%%%%%%
% %%%%%%%
%  .%%%%%  
%%%%%%%%%
