%%%%%%%
%   %%%
% %%%%%
%P%%%%%
%%%%%%%
%%%%%%%
