%%%%%%%%%
%P%  .%%%
% % %%%%%
%   %%%%%
%%%%%%%%%
