%%%%%%%%%
%P     .%
%%%%%%%%%
