%%%%%%%%%
%.     P%
%%%%%%%%%
