%%%%%%%%%
%  P  . %
%%%%%%%%%
