%%%%%
%.P %
%%% %
%   %
%%%%%
